###############################
#   #     #       #           #
# # ### ### ##### # ###########
# #     #   #   # #   #      B#
# ##### # ### # # ### ### # ###
#   #   # # # #     #   # #   #
# # ##### # # ### ##### # ### #
# # #     # #   # #     #   # #
### # ##### ### ### ##### ### #
#   # # #   #   #   #     #   #
# ### # # # # ### ### ##### ###
#     #   # #   # #   #   #   #
# ##### ### ### # # ### ##### #
#   #   #     # # #   # #   # #
### ##### ### # # ### # # # # #
# #     # # # #   #   #   # # #
# ##### # # # ##### ### ### # #
#     #   #   #     #   #   # #
# ### ##### ### ##### ### ### #
# # #     # # #   #     # #   #
# # ### ### # ### ####### # ###
# #   #     #   #     #   #   #
# # # ####### # ##### # ##### #
# # # #   #   #     # #     # #
# # # # # # ####### # ### ### #
# # #   #         #   #   #   #
# ################### # ### # #
# #   #         #   #   #   # #
# # # # ####### # # ##### ### #
A   #   #         #       #   #
##### #########################